0 71 22 88 94 36 37 37 46 41 11 38 59 56 95 40 62 35 70 32 77 84 14 56 21 19 63
71 0 83 39 92 60 48 41 34 17 97 16 58 77 86 94 57 25 87 26 63 17 92 51 31 42 84
22 83 0 37 19 74 94 50 13 28 18 57 88 53 10 50 98 45 38 27 60 76 45 94 75 46 99
88 39 37 0 97 55 34 95 25 79 67 33 24 36 60 55 80 71 51 39 80 93 98 52 36 93 54
94 92 19 97 0 17 83 32 41 43 33 12 54 47 48 87 77 84 18 79 34 36 92 13 15 64 17
36 60 74 55 17 0 76 43 30 85 64 68 71 48 33 39 91 75 52 25 73 88 71 61 29 97 83
37 48 94 34 83 76 0 69 60 65 80 59 72 100 56 24 83 34 80 70 60 66 33 92 53 28 50
37 41 50 95 32 43 69 0 74 16 73 93 45 28 70 13 25 27 28 52 62 51 38 87 69 62 55
46 34 13 25 41 30 60 74 0 20 13 96 99 82 23 29 91 57 92 45 39 16 98 70 64 46 74
41 17 28 79 43 85 65 16 20 0 86 85 16 73 72 54 11 43 56 29 58 92 77 23 71 81 46
11 97 18 67 33 64 80 73 13 86 0 89 73 21 84 11 95 15 16 29 66 16 30 29 37 86 75
38 16 57 33 12 68 59 93 96 85 89 0 28 77 48 33 70 88 32 56 58 10 24 64 21 55 54
59 58 88 24 54 71 72 45 99 16 73 28 0 87 13 42 75 87 57 71 54 48 96 32 69 99 54
56 77 53 36 47 48 100 28 82 73 21 77 87 0 52 59 58 51 71 77 22 88 41 42 25 65 39
95 86 10 60 48 33 56 70 23 72 84 48 13 52 0 25 81 28 76 70 76 93 75 78 66 63 71
40 94 50 55 87 39 24 13 29 54 11 33 42 59 25 0 15 99 27 13 43 99 25 52 100 49 68
62 57 98 80 77 91 83 25 91 11 95 70 75 58 81 15 0 77 57 49 97 56 27 36 92 49 22
35 25 45 71 84 75 34 27 57 43 15 88 87 51 28 99 77 0 22 88 47 88 29 55 51 96 46
70 87 38 51 18 52 80 28 92 56 16 32 57 71 76 27 57 22 0 13 51 57 100 26 76 99 19
32 26 27 39 79 25 70 52 45 29 29 56 71 77 70 13 49 88 13 0 91 81 48 77 16 32 99
77 63 60 80 34 73 60 62 39 58 66 58 54 22 76 43 97 47 51 91 0 97 35 81 42 85 31
84 17 76 93 36 88 66 51 16 92 16 10 48 88 93 99 56 88 57 81 97 0 57 81 86 60 86
14 92 45 98 92 71 33 38 98 77 30 24 96 41 75 25 27 29 100 48 35 57 0 35 43 80 21
56 51 94 52 13 61 92 87 70 23 29 64 32 42 78 52 36 55 26 77 81 81 35 0 68 75 59
21 31 75 36 15 29 53 69 64 71 37 21 69 25 66 100 92 51 76 16 42 86 43 68 0 37 97
19 42 46 93 64 97 28 62 46 81 86 55 99 65 63 49 49 96 99 32 85 60 80 75 37 0 14
63 84 99 54 17 83 50 55 74 46 75 54 54 39 71 68 22 46 19 99 31 86 21 59 97 14 0
